       NO         sprites/image.xpm
                EA sprites/image2.xpm
SO                  sprites/image3.xpm
WE sprites/image2.xpm

F 120,110,90
C 200,180,120

111111111111111
111111000111111
111110000011111
111100000001111
111000S00000111
110000000000111
100001111100001
110000111000011
111000010000111
111100000001111
111110000011111
111111000111111
111111111111111

