       NO         sprites/image.xpm
                EA sprites/image2.xpm
SO                  sprites/image3.xpm
WE sprites/image2.xpm

C 35,190,73
F 15,6,40

111111111111111
111111000111111
111110000011111
111100000001111
111000000000111
110000S00000011
100001111100001
110000111000011
111000010000111
111100000001111
111110000011111
111111000111111
111111111111111

