NO sprites/image.xpm
EA sprites/image2.xpm
SO sprites/image3.xpm
WE sprites/image3.xpm

F 120,110,90
C 200,180,120

111111111111111111111111
10000000000000000000000111111111111111111111111111111111111111111111111111111111111111111111111111111111111111111111111
10000000000000000000000011111111111111111111111111111111111111111111111111111111111111111110000011111101010111111111
100000000N0000100000000000000000000000000000000000000000000000000000000000000000000000000000000000000000000000000001
10000000000000010000000000000000000000000000000000000000000000000000000000000000000000000000000000000000000000000001
100000000000000000000001111111111111111111111111111111111111111111111111111111111100011010101010101010101011111111111111111
1000000000000000000000011111111111111111111111111111111111111111111111111111111111111111111111111111111111111111111111111111111111
100000111110000101010001
100000100010000000000001
100000100010000100010001
100000100010000000000001
100000111100001010100001
100000000000000000000001
100000000000000000000001
100000000000000000000001
100000000000000000000001
100000000000000000000001
100000000000000000000001
100000000000000000000001
111111111000000000000001
100100001000000000000001
100000101000000000000001
100100001000000000000001
100111111000000000000001
100000000000000000000001
100000000000000000000001
111111111111111111111111
