NO sprites/image.xpm
SO sprites/image.xpm
WE sprites/image.xpm
EA sprites/image.xpm

F 153,140,102
C 240,230,180

        1111111111111111111111111
        1000000000110000000000001
        10110000011100001000W0001
        1001000000000000010000001
111111111011000001110000000000001
100000000011000001110111111111111
11110111111111011100000010001
11110111111111011101010010001
11000000110101011100000010001
10000000000000001100000010001
10000000000000001101010010001
110000011101010111110111100111
11110111 1110101 101111010001
11111111 1111111 111111111111
