NO sprites/image.xpm
SO sprites/image.xpm
WE sprites/image.xpm
EA sprites/image.xpm

F 153,140,102
C 153,140,102

111111111111111111111
1E0000000000000000001
111111111111111111111
