NO sprites/image.xpm
SO sprites/image.xpm
WE sprites/image.xpm
EA sprites/image.xpm

F 180,160,90
C 240,230,180

111111111111111111111
1W0000000000000000001
111111111111111111111
